NetSceneBaseEx<micromsg::AddChatRoomMemberRequest,micromsg::AddChatRoomMemberResponse>	NetSceneBaseEx<micromsg::AddChatRoomMemberRequest,micromsg::AddChatRoomMemberResponse>: NetSceneBase, InstanceCounter<NetSceneBase,100>;
NetSceneBaseEx<micromsg::AddContactLabelRequest,micromsg::AddContactLabelResponse>	NetSceneBaseEx<micromsg::AddContactLabelRequest,micromsg::AddContactLabelResponse>: NetSceneBase, InstanceCounter<NetSceneBase,100>;
NetSceneBaseEx<micromsg::AddFavItemRequest,micromsg::AddFavItemResponse>	NetSceneBaseEx<micromsg::AddFavItemRequest,micromsg::AddFavItemResponse>: NetSceneBase, InstanceCounter<NetSceneBase,100>;
NetSceneBaseEx<micromsg::AgreeTeenagerModeAuthorizationReq,micromsg::AgreeTeenagerModeAuthorizationResp>	NetSceneBaseEx<micromsg::AgreeTeenagerModeAuthorizationReq,micromsg::AgreeTeenagerModeAuthorizationResp>: NetSceneBase, InstanceCounter<NetSceneBase,100>;
NetSceneBaseEx<micromsg::AppMsgReportReq,micromsg::AppMsgReportResp>	NetSceneBaseEx<micromsg::AppMsgReportReq,micromsg::AppMsgReportResp>: NetSceneBase, InstanceCounter<NetSceneBase,100>;
NetSceneBaseEx<micromsg::AuthUserAutoFillInfoReq,micromsg::AuthUserAutoFillInfoResp>	NetSceneBaseEx<micromsg::AuthUserAutoFillInfoReq,micromsg::AuthUserAutoFillInfoResp>: NetSceneBase, InstanceCounter<NetSceneBase,100>;
NetSceneBaseEx<micromsg::BatchBindTagsRequest,micromsg::BatchBindTagsResponse>	NetSceneBaseEx<micromsg::BatchBindTagsRequest,micromsg::BatchBindTagsResponse>: NetSceneBase, InstanceCounter<NetSceneBase,100>;
NetSceneBaseEx<micromsg::BatchCheckBigFileUploadRequest,micromsg::BatchCheckBigFileUploadResponse>	NetSceneBaseEx<micromsg::BatchCheckBigFileUploadRequest,micromsg::BatchCheckBigFileUploadResponse>: NetSceneBase, InstanceCounter<NetSceneBase,100>;
NetSceneBaseEx<micromsg::BatchDelFavItemRequest,micromsg::BatchDelFavItemResponse>	NetSceneBaseEx<micromsg::BatchDelFavItemRequest,micromsg::BatchDelFavItemResponse>: NetSceneBase, InstanceCounter<NetSceneBase,100>;
NetSceneBaseEx<micromsg::BatchDelTagsRequest,micromsg::BatchDelTagsResponse>	NetSceneBaseEx<micromsg::BatchDelTagsRequest,micromsg::BatchDelTagsResponse>: NetSceneBase, InstanceCounter<NetSceneBase,100>;
NetSceneBaseEx<micromsg::BatchGetAppMsgReq,micromsg::BatchGetAppMsgResp>	NetSceneBaseEx<micromsg::BatchGetAppMsgReq,micromsg::BatchGetAppMsgResp>: NetSceneBase, InstanceCounter<NetSceneBase,100>;
NetSceneBaseEx<micromsg::BatchGetDownloadUrlRequest,micromsg::BatchGetDownloadUrlResponse>	NetSceneBaseEx<micromsg::BatchGetDownloadUrlRequest,micromsg::BatchGetDownloadUrlResponse>: NetSceneBase, InstanceCounter<NetSceneBase,100>;
NetSceneBaseEx<micromsg::BatchGetFavItemRequest,micromsg::BatchGetFavItemResponse>	NetSceneBaseEx<micromsg::BatchGetFavItemRequest,micromsg::BatchGetFavItemResponse>: NetSceneBase, InstanceCounter<NetSceneBase,100>;
NetSceneBaseEx<micromsg::BatchGetHeadImgRequest,micromsg::BatchGetHeadImgResponse>	NetSceneBaseEx<micromsg::BatchGetHeadImgRequest,micromsg::BatchGetHeadImgResponse>: NetSceneBase, InstanceCounter<NetSceneBase,100>;
NetSceneBaseEx<micromsg::BatchModContactTypeRequest,micromsg::BatchModContactTypeResponse>	NetSceneBaseEx<micromsg::BatchModContactTypeRequest,micromsg::BatchModContactTypeResponse>: NetSceneBase, InstanceCounter<NetSceneBase,100>;
NetSceneBaseEx<micromsg::BatchRenameTagsRequest,micromsg::BatchRenameTagsResponse>	NetSceneBaseEx<micromsg::BatchRenameTagsRequest,micromsg::BatchRenameTagsResponse>: NetSceneBase, InstanceCounter<NetSceneBase,100>;
NetSceneBaseEx<micromsg::BatchSyncVersionReq,micromsg::BatchSyncVersionResp>	NetSceneBaseEx<micromsg::BatchSyncVersionReq,micromsg::BatchSyncVersionResp>: NetSceneBase, InstanceCounter<NetSceneBase,100>;
NetSceneBaseEx<micromsg::BatchWxaAttrSyncRequest,micromsg::BatchWxaAttrSyncResponse>	NetSceneBaseEx<micromsg::BatchWxaAttrSyncRequest,micromsg::BatchWxaAttrSyncResponse>: NetSceneBase, InstanceCounter<NetSceneBase,100>;
NetSceneBaseEx<micromsg::BizAiScanImageSceneRequest,micromsg::BizAiScanImageSceneResponse>	NetSceneBaseEx<micromsg::BizAiScanImageSceneRequest,micromsg::BizAiScanImageSceneResponse>: NetSceneBase, InstanceCounter<NetSceneBase,100>;
NetSceneBaseEx<micromsg::BizAppMsgRelatedInfoReq,micromsg::BizAppMsgRelatedInfoResp>	NetSceneBaseEx<micromsg::BizAppMsgRelatedInfoReq,micromsg::BizAppMsgRelatedInfoResp>: NetSceneBase, InstanceCounter<NetSceneBase,100>;
NetSceneBaseEx<micromsg::BizAttrSyncReq,micromsg::BizAttrSyncResp>	NetSceneBaseEx<micromsg::BizAttrSyncReq,micromsg::BizAttrSyncResp>: NetSceneBase, InstanceCounter<NetSceneBase,100>;
NetSceneBaseEx<micromsg::BizFinderLiveReq,micromsg::BizFinderLiveResp>	NetSceneBaseEx<micromsg::BizFinderLiveReq,micromsg::BizFinderLiveResp>: NetSceneBase, InstanceCounter<NetSceneBase,100>;
NetSceneBaseEx<micromsg::BizOcrImageRequest,micromsg::BizOcrImageResponse>	NetSceneBaseEx<micromsg::BizOcrImageRequest,micromsg::BizOcrImageResponse>: NetSceneBase, InstanceCounter<NetSceneBase,100>;
NetSceneBaseEx<micromsg::BizProfileV2Req,micromsg::BizProfileV2Resp>	NetSceneBaseEx<micromsg::BizProfileV2Req,micromsg::BizProfileV2Resp>: NetSceneBase, InstanceCounter<NetSceneBase,100>;
NetSceneBaseEx<micromsg::BizStrategyReq,micromsg::BizStrategyResp>	NetSceneBaseEx<micromsg::BizStrategyReq,micromsg::BizStrategyResp>: NetSceneBase, InstanceCounter<NetSceneBase,100>;
NetSceneBaseEx<micromsg::BypSyncRequest,micromsg::BypSyncResponse>	NetSceneBaseEx<micromsg::BypSyncRequest,micromsg::BypSyncResponse>: NetSceneBase, InstanceCounter<NetSceneBase,100>;
NetSceneBaseEx<micromsg::ChatRoomTopMsgRequest,micromsg::ChatRoomTopMsgResponse>	NetSceneBaseEx<micromsg::ChatRoomTopMsgRequest,micromsg::ChatRoomTopMsgResponse>: NetSceneBase, InstanceCounter<NetSceneBase,100>;
NetSceneBaseEx<micromsg::CheckBigFileDownloadRequest,micromsg::CheckBigFileDownloadResponse>	NetSceneBaseEx<micromsg::CheckBigFileDownloadRequest,micromsg::CheckBigFileDownloadResponse>: NetSceneBase, InstanceCounter<NetSceneBase,100>;
NetSceneBaseEx<micromsg::CheckBigFileUploadRequest,micromsg::CheckBigFileUploadResponse>	NetSceneBaseEx<micromsg::CheckBigFileUploadRequest,micromsg::CheckBigFileUploadResponse>: NetSceneBase, InstanceCounter<NetSceneBase,100>;
NetSceneBaseEx<micromsg::CheckCDNRequest,micromsg::CheckCDNResponse>	NetSceneBaseEx<micromsg::CheckCDNRequest,micromsg::CheckCDNResponse>: NetSceneBase, InstanceCounter<NetSceneBase,100>;
NetSceneBaseEx<micromsg::CheckDemoInfoRequest,micromsg::CheckDemoInfoResponse>	NetSceneBaseEx<micromsg::CheckDemoInfoRequest,micromsg::CheckDemoInfoResponse>: NetSceneBase, InstanceCounter<NetSceneBase,100>;
NetSceneBaseEx<micromsg::CheckLoginQRCodeRequest,micromsg::CheckLoginQRCodeResponse>	NetSceneBaseEx<micromsg::CheckLoginQRCodeRequest,micromsg::CheckLoginQRCodeResponse>: NetSceneBase, InstanceCounter<NetSceneBase,100>;
NetSceneBaseEx<micromsg::CheckMd5Request,micromsg::CheckMd5Response>	NetSceneBaseEx<micromsg::CheckMd5Request,micromsg::CheckMd5Response>: NetSceneBase, InstanceCounter<NetSceneBase,100>;
NetSceneBaseEx<micromsg::CheckShortLinkReq,micromsg::CheckShortLinkResp>	NetSceneBaseEx<micromsg::CheckShortLinkReq,micromsg::CheckShortLinkResp>: NetSceneBase, InstanceCounter<NetSceneBase,100>;
NetSceneBaseEx<micromsg::CheckTmplVerReq,micromsg::CheckTmplVerResp>	NetSceneBaseEx<micromsg::CheckTmplVerReq,micromsg::CheckTmplVerResp>: NetSceneBase, InstanceCounter<NetSceneBase,100>;
NetSceneBaseEx<micromsg::CheckVoiceTransRequest,micromsg::CheckVoiceTransResponse>	NetSceneBaseEx<micromsg::CheckVoiceTransRequest,micromsg::CheckVoiceTransResponse>: NetSceneBase, InstanceCounter<NetSceneBase,100>;
NetSceneBaseEx<micromsg::ClickCommandRequest,micromsg::ClickCommandResponse>	NetSceneBaseEx<micromsg::ClickCommandRequest,micromsg::ClickCommandResponse>: NetSceneBase, InstanceCounter<NetSceneBase,100>;
NetSceneBaseEx<micromsg::ConvertBizChatReq,micromsg::ConvertBizChatResp>	NetSceneBaseEx<micromsg::ConvertBizChatReq,micromsg::ConvertBizChatResp>: NetSceneBase, InstanceCounter<NetSceneBase,100>;
NetSceneBaseEx<micromsg::CreateBizChatInfoReq,micromsg::CreateBizChatInfoResp>	NetSceneBaseEx<micromsg::CreateBizChatInfoReq,micromsg::CreateBizChatInfoResp>: NetSceneBase, InstanceCounter<NetSceneBase,100>;
NetSceneBaseEx<micromsg::CreateChatRoomRequest,micromsg::CreateChatRoomResponse>	NetSceneBaseEx<micromsg::CreateChatRoomRequest,micromsg::CreateChatRoomResponse>: NetSceneBase, InstanceCounter<NetSceneBase,100>;
NetSceneBaseEx<micromsg::DecryptForwardWechatMsgReq,micromsg::DecryptForwardWechatMsgResp>	NetSceneBaseEx<micromsg::DecryptForwardWechatMsgReq,micromsg::DecryptForwardWechatMsgResp>: NetSceneBase, InstanceCounter<NetSceneBase,100>;
NetSceneBaseEx<micromsg::DelChatRoomMemberRequest,micromsg::DelChatRoomMemberResponse>	NetSceneBaseEx<micromsg::DelChatRoomMemberRequest,micromsg::DelChatRoomMemberResponse>: NetSceneBase, InstanceCounter<NetSceneBase,100>;
NetSceneBaseEx<micromsg::DelContactLabelRequest,micromsg::DelContactLabelResponse>	NetSceneBaseEx<micromsg::DelContactLabelRequest,micromsg::DelContactLabelResponse>: NetSceneBase, InstanceCounter<NetSceneBase,100>;
NetSceneBaseEx<micromsg::DeleteUserAutoFillInfoReq,micromsg::DeleteUserAutoFillInfoResp>	NetSceneBaseEx<micromsg::DeleteUserAutoFillInfoReq,micromsg::DeleteUserAutoFillInfoResp>: NetSceneBase, InstanceCounter<NetSceneBase,100>;
NetSceneBaseEx<micromsg::DownLoadPackageRequest,micromsg::DownLoadPackageResponse>	NetSceneBaseEx<micromsg::DownLoadPackageRequest,micromsg::DownLoadPackageResponse>: NetSceneBase, InstanceCounter<NetSceneBase,100>;
NetSceneBaseEx<micromsg::DownloadAppAttachRequest,micromsg::DownloadAppAttachResponse>	NetSceneBaseEx<micromsg::DownloadAppAttachRequest,micromsg::DownloadAppAttachResponse>: NetSceneBase, InstanceCounter<NetSceneBase,100>;
NetSceneBaseEx<micromsg::DownloadVideoRequest,micromsg::DownloadVideoResponse>	NetSceneBaseEx<micromsg::DownloadVideoRequest,micromsg::DownloadVideoResponse>: NetSceneBase, InstanceCounter<NetSceneBase,100>;
NetSceneBaseEx<micromsg::DownloadVoiceRequest,micromsg::DownloadVoiceResponse>	NetSceneBaseEx<micromsg::DownloadVoiceRequest,micromsg::DownloadVoiceResponse>: NetSceneBase, InstanceCounter<NetSceneBase,100>;
NetSceneBaseEx<micromsg::EncryptForwardWxworkMsgReq,micromsg::EncryptForwardWxworkMsgResp>	NetSceneBaseEx<micromsg::EncryptForwardWxworkMsgReq,micromsg::EncryptForwardWxworkMsgResp>: NetSceneBase, InstanceCounter<NetSceneBase,100>;
NetSceneBaseEx<micromsg::EnterTempSessionRequest,micromsg::EnterTempSessionResponse>	NetSceneBaseEx<micromsg::EnterTempSessionRequest,micromsg::EnterTempSessionResponse>: NetSceneBase, InstanceCounter<NetSceneBase,100>;
NetSceneBaseEx<micromsg::ExchangeEmotionPackRequest,micromsg::ExchangeEmotionPackResponse>	NetSceneBaseEx<micromsg::ExchangeEmotionPackRequest,micromsg::ExchangeEmotionPackResponse>: NetSceneBase, InstanceCounter<NetSceneBase,100>;
NetSceneBaseEx<micromsg::ExtDeviceOpLogReq,micromsg::ExtDeviceOpLogResp>	NetSceneBaseEx<micromsg::ExtDeviceOpLogReq,micromsg::ExtDeviceOpLogResp>: NetSceneBase, InstanceCounter<NetSceneBase,100>;
NetSceneBaseEx<micromsg::FinderClearPCReddotRequest,micromsg::FinderClearPCReddotResponse>	NetSceneBaseEx<micromsg::FinderClearPCReddotRequest,micromsg::FinderClearPCReddotResponse>: NetSceneBase, InstanceCounter<NetSceneBase,100>;
NetSceneBaseEx<micromsg::FinderCreateLivePrepareRequest,micromsg::FinderCreateLivePrepareResponse>	NetSceneBaseEx<micromsg::FinderCreateLivePrepareRequest,micromsg::FinderCreateLivePrepareResponse>: NetSceneBase, InstanceCounter<NetSceneBase,100>;
NetSceneBaseEx<micromsg::FinderGetLiveInfoReq,micromsg::FinderGetLiveInfoResp>	NetSceneBaseEx<micromsg::FinderGetLiveInfoReq,micromsg::FinderGetLiveInfoResp>: NetSceneBase, InstanceCounter<NetSceneBase,100>;
NetSceneBaseEx<micromsg::FinderGetLiveMsgReq,micromsg::FinderGetLiveMsgResp>	NetSceneBaseEx<micromsg::FinderGetLiveMsgReq,micromsg::FinderGetLiveMsgResp>: NetSceneBase, InstanceCounter<NetSceneBase,100>;
NetSceneBaseEx<micromsg::FinderGetPCReddotRequest,micromsg::FinderGetPCReddotResponse>	NetSceneBaseEx<micromsg::FinderGetPCReddotRequest,micromsg::FinderGetPCReddotResponse>: NetSceneBase, InstanceCounter<NetSceneBase,100>;
NetSceneBaseEx<micromsg::FinderGetUserRequest,micromsg::FinderGetUserResponse>	NetSceneBaseEx<micromsg::FinderGetUserRequest,micromsg::FinderGetUserResponse>: NetSceneBase, InstanceCounter<NetSceneBase,100>;
NetSceneBaseEx<micromsg::FinderInitRequest,micromsg::FinderInitResponse>	NetSceneBaseEx<micromsg::FinderInitRequest,micromsg::FinderInitResponse>: NetSceneBase, InstanceCounter<NetSceneBase,100>;
NetSceneBaseEx<micromsg::FinderJoinLiveReq,micromsg::FinderJoinLiveResp>	NetSceneBaseEx<micromsg::FinderJoinLiveReq,micromsg::FinderJoinLiveResp>: NetSceneBase, InstanceCounter<NetSceneBase,100>;
NetSceneBaseEx<micromsg::FinderSetAnchorStatusRequest,micromsg::FinderSetAnchorStatusResponse>	NetSceneBaseEx<micromsg::FinderSetAnchorStatusRequest,micromsg::FinderSetAnchorStatusResponse>: NetSceneBase, InstanceCounter<NetSceneBase,100>;
NetSceneBaseEx<micromsg::FinderUserPrepareRequest,micromsg::FinderNewUserPrepareResponse>	NetSceneBaseEx<micromsg::FinderUserPrepareRequest,micromsg::FinderNewUserPrepareResponse>: NetSceneBase, InstanceCounter<NetSceneBase,100>;
NetSceneBaseEx<micromsg::FinderWebStatsReportRequest,micromsg::FinderWebStatsReportResponse>	NetSceneBaseEx<micromsg::FinderWebStatsReportRequest,micromsg::FinderWebStatsReportResponse>: NetSceneBase, InstanceCounter<NetSceneBase,100>;
NetSceneBaseEx<micromsg::GetA8KeyReq,micromsg::GetA8KeyResp>	NetSceneBaseEx<micromsg::GetA8KeyReq,micromsg::GetA8KeyResp>: NetSceneBase, InstanceCounter<NetSceneBase,100>;
NetSceneBaseEx<micromsg::GetAndroidIapPackageReq,micromsg::GetAndroidIapPackageResp>	NetSceneBaseEx<micromsg::GetAndroidIapPackageReq,micromsg::GetAndroidIapPackageResp>: NetSceneBase, InstanceCounter<NetSceneBase,100>;
NetSceneBaseEx<micromsg::GetAppInfoRequest,micromsg::GetAppInfoResponse>	NetSceneBaseEx<micromsg::GetAppInfoRequest,micromsg::GetAppInfoResponse>: NetSceneBase, InstanceCounter<NetSceneBase,100>;
NetSceneBaseEx<micromsg::GetBizChatInfoReq,micromsg::GetBizChatInfoResp>	NetSceneBaseEx<micromsg::GetBizChatInfoReq,micromsg::GetBizChatInfoResp>: NetSceneBase, InstanceCounter<NetSceneBase,100>;
NetSceneBaseEx<micromsg::GetBizChatMyUserInfoReq,micromsg::GetBizChatMyUserInfoResp>	NetSceneBaseEx<micromsg::GetBizChatMyUserInfoReq,micromsg::GetBizChatMyUserInfoResp>: NetSceneBase, InstanceCounter<NetSceneBase,100>;
NetSceneBaseEx<micromsg::GetBizChatUserDetailListReq,micromsg::GetBizChatUserDetailListResp>	NetSceneBaseEx<micromsg::GetBizChatUserDetailListReq,micromsg::GetBizChatUserDetailListResp>: NetSceneBase, InstanceCounter<NetSceneBase,100>;
NetSceneBaseEx<micromsg::GetBizChatUserInfoListReq,micromsg::GetBizChatUserInfoListResp>	NetSceneBaseEx<micromsg::GetBizChatUserInfoListReq,micromsg::GetBizChatUserInfoListResp>: NetSceneBase, InstanceCounter<NetSceneBase,100>;
NetSceneBaseEx<micromsg::GetBizJsApiRedirectUrlReq,micromsg::GetBizJsApiRedirectUrlResp>	NetSceneBaseEx<micromsg::GetBizJsApiRedirectUrlReq,micromsg::GetBizJsApiRedirectUrlResp>: NetSceneBase, InstanceCounter<NetSceneBase,100>;
NetSceneBaseEx<micromsg::GetBizNewFeedsV2Req,micromsg::GetBizNewFeedsV2Resp>	NetSceneBaseEx<micromsg::GetBizNewFeedsV2Req,micromsg::GetBizNewFeedsV2Resp>: NetSceneBase, InstanceCounter<NetSceneBase,100>;
NetSceneBaseEx<micromsg::GetCDNDnsRequest,micromsg::GetCDNDnsResponse>	NetSceneBaseEx<micromsg::GetCDNDnsRequest,micromsg::GetCDNDnsResponse>: NetSceneBase, InstanceCounter<NetSceneBase,100>;
NetSceneBaseEx<micromsg::GetCertRequest,micromsg::GetCertResponse>	NetSceneBaseEx<micromsg::GetCertRequest,micromsg::GetCertResponse>: NetSceneBase, InstanceCounter<NetSceneBase,100>;
NetSceneBaseEx<micromsg::GetChatRoomInfoDetailRequest,micromsg::GetChatRoomInfoDetailResponse>	NetSceneBaseEx<micromsg::GetChatRoomInfoDetailRequest,micromsg::GetChatRoomInfoDetailResponse>: NetSceneBase, InstanceCounter<NetSceneBase,100>;
NetSceneBaseEx<micromsg::GetChatroomMemberDetailRequest,micromsg::GetChatroomMemberDetailResponse>	NetSceneBaseEx<micromsg::GetChatroomMemberDetailRequest,micromsg::GetChatroomMemberDetailResponse>: NetSceneBase, InstanceCounter<NetSceneBase,100>;
NetSceneBaseEx<micromsg::GetCloudIMSessionRequest,micromsg::GetCloudIMSessionResponse>	NetSceneBaseEx<micromsg::GetCloudIMSessionRequest,micromsg::GetCloudIMSessionResponse>: NetSceneBase, InstanceCounter<NetSceneBase,100>;
NetSceneBaseEx<micromsg::GetConnectInfoRequest,micromsg::GetConnectInfoResponse>	NetSceneBaseEx<micromsg::GetConnectInfoRequest,micromsg::GetConnectInfoResponse>: NetSceneBase, InstanceCounter<NetSceneBase,100>;
NetSceneBaseEx<micromsg::GetContactLabelListRequest,micromsg::GetContactLabelListResponse>	NetSceneBaseEx<micromsg::GetContactLabelListRequest,micromsg::GetContactLabelListResponse>: NetSceneBase, InstanceCounter<NetSceneBase,100>;
NetSceneBaseEx<micromsg::GetContactRequest,micromsg::GetContactResponse>	NetSceneBaseEx<micromsg::GetContactRequest,micromsg::GetContactResponse>: NetSceneBase, InstanceCounter<NetSceneBase,100>;
NetSceneBaseEx<micromsg::GetDynacfgBizReq,micromsg::GetDynacfgBizResp>	NetSceneBaseEx<micromsg::GetDynacfgBizReq,micromsg::GetDynacfgBizResp>: NetSceneBase, InstanceCounter<NetSceneBase,100>;
NetSceneBaseEx<micromsg::GetEmotionDescRequest,micromsg::GetEmotionDescResponse>	NetSceneBaseEx<micromsg::GetEmotionDescRequest,micromsg::GetEmotionDescResponse>: NetSceneBase, InstanceCounter<NetSceneBase,100>;
NetSceneBaseEx<micromsg::GetEmotionDetailRequest,micromsg::GetEmotionDetailResponse>	NetSceneBaseEx<micromsg::GetEmotionDetailRequest,micromsg::GetEmotionDetailResponse>: NetSceneBase, InstanceCounter<NetSceneBase,100>;
NetSceneBaseEx<micromsg::GetEmotionListRequest,micromsg::GetEmotionListResponse>	NetSceneBaseEx<micromsg::GetEmotionListRequest,micromsg::GetEmotionListResponse>: NetSceneBase, InstanceCounter<NetSceneBase,100>;
NetSceneBaseEx<micromsg::GetExptAppConfigRequest,micromsg::GetExptAppConfigResponse>	NetSceneBaseEx<micromsg::GetExptAppConfigRequest,micromsg::GetExptAppConfigResponse>: NetSceneBase, InstanceCounter<NetSceneBase,100>;
NetSceneBaseEx<micromsg::GetFavInfoRequest,micromsg::GetFavInfoResponse>	NetSceneBaseEx<micromsg::GetFavInfoRequest,micromsg::GetFavInfoResponse>: NetSceneBase, InstanceCounter<NetSceneBase,100>;
NetSceneBaseEx<micromsg::GetFuncMsgReq,micromsg::GetFuncMsgResp>	NetSceneBaseEx<micromsg::GetFuncMsgReq,micromsg::GetFuncMsgResp>: NetSceneBase, InstanceCounter<NetSceneBase,100>;
NetSceneBaseEx<micromsg::GetHDHeadImgRequest,micromsg::GetHDHeadImgResponse>	NetSceneBaseEx<micromsg::GetHDHeadImgRequest,micromsg::GetHDHeadImgResponse>: NetSceneBase, InstanceCounter<NetSceneBase,100>;
NetSceneBaseEx<micromsg::GetILinkAuthCodeReq,micromsg::GetILinkAuthCodeResp>	NetSceneBaseEx<micromsg::GetILinkAuthCodeReq,micromsg::GetILinkAuthCodeResp>: NetSceneBase, InstanceCounter<NetSceneBase,100>;
NetSceneBaseEx<micromsg::GetLiveInfoRequest,micromsg::GetLiveInfoResponse>	NetSceneBaseEx<micromsg::GetLiveInfoRequest,micromsg::GetLiveInfoResponse>: NetSceneBase, InstanceCounter<NetSceneBase,100>;
NetSceneBaseEx<micromsg::GetLocImgRequest,micromsg::GetLocImgResponse>	NetSceneBaseEx<micromsg::GetLocImgRequest,micromsg::GetLocImgResponse>: NetSceneBase, InstanceCounter<NetSceneBase,100>;
NetSceneBaseEx<micromsg::GetLocationInfoByIpRequest,micromsg::GetLocationInfoByIpResponse>	NetSceneBaseEx<micromsg::GetLocationInfoByIpRequest,micromsg::GetLocationInfoByIpResponse>: NetSceneBase, InstanceCounter<NetSceneBase,100>;
NetSceneBaseEx<micromsg::GetLoginQRCodeRequest,micromsg::GetLoginQRCodeResponse>	NetSceneBaseEx<micromsg::GetLoginQRCodeRequest,micromsg::GetLoginQRCodeResponse>: NetSceneBase, InstanceCounter<NetSceneBase,100>;
NetSceneBaseEx<micromsg::GetMsgImgRequest,micromsg::GetMsgImgResponse>	NetSceneBaseEx<micromsg::GetMsgImgRequest,micromsg::GetMsgImgResponse>: NetSceneBase, InstanceCounter<NetSceneBase,100>;
NetSceneBaseEx<micromsg::GetOnlineInfoRequest,micromsg::GetOnlineInfoResponse>	NetSceneBaseEx<micromsg::GetOnlineInfoRequest,micromsg::GetOnlineInfoResponse>: NetSceneBase, InstanceCounter<NetSceneBase,100>;
NetSceneBaseEx<micromsg::GetPackageListRequest,micromsg::GetPackageListResponse>	NetSceneBaseEx<micromsg::GetPackageListRequest,micromsg::GetPackageListResponse>: NetSceneBase, InstanceCounter<NetSceneBase,100>;
NetSceneBaseEx<micromsg::GetProfileRequest,micromsg::GetProfileResponse>	NetSceneBaseEx<micromsg::GetProfileRequest,micromsg::GetProfileResponse>: NetSceneBase, InstanceCounter<NetSceneBase,100>;
NetSceneBaseEx<micromsg::GetRuntimeSessionRequest,micromsg::GetRuntimeSessionResponse>	NetSceneBaseEx<micromsg::GetRuntimeSessionRequest,micromsg::GetRuntimeSessionResponse>: NetSceneBase, InstanceCounter<NetSceneBase,100>;
NetSceneBaseEx<micromsg::GetSubBusinessInfoRequest,micromsg::GetSubBusinessInfoResponse>	NetSceneBaseEx<micromsg::GetSubBusinessInfoRequest,micromsg::GetSubBusinessInfoResponse>: NetSceneBase, InstanceCounter<NetSceneBase,100>;
NetSceneBaseEx<micromsg::GetTestCodeDownloadInfoRequest,micromsg::GetTestCodeDownloadInfoResponse>	NetSceneBaseEx<micromsg::GetTestCodeDownloadInfoRequest,micromsg::GetTestCodeDownloadInfoResponse>: NetSceneBase, InstanceCounter<NetSceneBase,100>;
NetSceneBaseEx<micromsg::GetTransTextRequest,micromsg::GetTransTextResponse>	NetSceneBaseEx<micromsg::GetTransTextRequest,micromsg::GetTransTextResponse>: NetSceneBase, InstanceCounter<NetSceneBase,100>;
NetSceneBaseEx<micromsg::GetUpdatableMsgInfoRequest,micromsg::GetUpdatableMsgInfoResponse>	NetSceneBaseEx<micromsg::GetUpdatableMsgInfoRequest,micromsg::GetUpdatableMsgInfoResponse>: NetSceneBase, InstanceCounter<NetSceneBase,100>;
NetSceneBaseEx<micromsg::GetUpdateInfoRequest,micromsg::GetUpdateInfoResponse>	NetSceneBaseEx<micromsg::GetUpdateInfoRequest,micromsg::GetUpdateInfoResponse>: NetSceneBase, InstanceCounter<NetSceneBase,100>;
NetSceneBaseEx<micromsg::GetUserAutoFillInfoReq,micromsg::GetUserAutoFillInfoResp>	NetSceneBaseEx<micromsg::GetUserAutoFillInfoReq,micromsg::GetUserAutoFillInfoResp>: NetSceneBase, InstanceCounter<NetSceneBase,100>;
NetSceneBaseEx<micromsg::GetVoiceTransResRequest,micromsg::GetVoiceTransResResponse>	NetSceneBaseEx<micromsg::GetVoiceTransResRequest,micromsg::GetVoiceTransResResponse>: NetSceneBase, InstanceCounter<NetSceneBase,100>;
NetSceneBaseEx<micromsg::GetWxaAppCDNDownloadUrlRequest,micromsg::GetWxaAppCDNDownloadUrlResponse>	NetSceneBaseEx<micromsg::GetWxaAppCDNDownloadUrlRequest,micromsg::GetWxaAppCDNDownloadUrlResponse>: NetSceneBase, InstanceCounter<NetSceneBase,100>;
NetSceneBaseEx<micromsg::GetWxaGameConfigRequest,micromsg::GetWxaGameConfigResponse>	NetSceneBaseEx<micromsg::GetWxaGameConfigRequest,micromsg::GetWxaGameConfigResponse>: NetSceneBase, InstanceCounter<NetSceneBase,100>;
NetSceneBaseEx<micromsg::GetWxaUsageRecordRequest,micromsg::GetWxaUsageRecordResponse>	NetSceneBaseEx<micromsg::GetWxaUsageRecordRequest,micromsg::GetWxaUsageRecordResponse>: NetSceneBase, InstanceCounter<NetSceneBase,100>;
NetSceneBaseEx<micromsg::GetXlabExptRequest,micromsg::GetXlabExptResponse>	NetSceneBaseEx<micromsg::GetXlabExptRequest,micromsg::GetXlabExptResponse>: NetSceneBase, InstanceCounter<NetSceneBase,100>;
NetSceneBaseEx<micromsg::H5AuthRequest,micromsg::H5AuthResponse>	NetSceneBaseEx<micromsg::H5AuthRequest,micromsg::H5AuthResponse>: NetSceneBase, InstanceCounter<NetSceneBase,100>;
NetSceneBaseEx<micromsg::H5ExtTransferRequest,micromsg::H5ExtTransferResponse>	NetSceneBaseEx<micromsg::H5ExtTransferRequest,micromsg::H5ExtTransferResponse>: NetSceneBase, InstanceCounter<NetSceneBase,100>;
NetSceneBaseEx<micromsg::HeartBeatRequest,micromsg::HeartBeatResponse>	NetSceneBaseEx<micromsg::HeartBeatRequest,micromsg::HeartBeatResponse>: NetSceneBase, InstanceCounter<NetSceneBase,100>;
NetSceneBaseEx<micromsg::ILinkCloudAppAuthReq,micromsg::ILinkCloudAppAuthResp>	NetSceneBaseEx<micromsg::ILinkCloudAppAuthReq,micromsg::ILinkCloudAppAuthResp>: NetSceneBase, InstanceCounter<NetSceneBase,100>;
NetSceneBaseEx<micromsg::IlinkTransferRequest,micromsg::ILinkTransferResponse>	NetSceneBaseEx<micromsg::IlinkTransferRequest,micromsg::ILinkTransferResponse>: NetSceneBase, InstanceCounter<NetSceneBase,100>;
NetSceneBaseEx<micromsg::InitiateBizChatReq,micromsg::InitiateBizChatResp>	NetSceneBaseEx<micromsg::InitiateBizChatReq,micromsg::InitiateBizChatResp>: NetSceneBase, InstanceCounter<NetSceneBase,100>;
NetSceneBaseEx<micromsg::InviteChatRoomMemberRequest,micromsg::InviteChatRoomMemberResponse>	NetSceneBaseEx<micromsg::InviteChatRoomMemberRequest,micromsg::InviteChatRoomMemberResponse>: NetSceneBase, InstanceCounter<NetSceneBase,100>;
NetSceneBaseEx<micromsg::JSAPICheckLaunchAppRequest,micromsg::JSAPICheckLaunchAppResponse>	NetSceneBaseEx<micromsg::JSAPICheckLaunchAppRequest,micromsg::JSAPICheckLaunchAppResponse>: NetSceneBase, InstanceCounter<NetSceneBase,100>;
NetSceneBaseEx<micromsg::JSAPIPreVerifyRequest,micromsg::JSAPIPreVerifyResponse>	NetSceneBaseEx<micromsg::JSAPIPreVerifyRequest,micromsg::JSAPIPreVerifyResponse>: NetSceneBase, InstanceCounter<NetSceneBase,100>;
NetSceneBaseEx<micromsg::JSAPIRealtimeVerifyRequest,micromsg::JSAPIRealtimeVerifyResponse>	NetSceneBaseEx<micromsg::JSAPIRealtimeVerifyRequest,micromsg::JSAPIRealtimeVerifyResponse>: NetSceneBase, InstanceCounter<NetSceneBase,100>;
NetSceneBaseEx<micromsg::JSAuthorizeConfirmRequest,micromsg::JSAuthorizeConfirmResponse>	NetSceneBaseEx<micromsg::JSAuthorizeConfirmRequest,micromsg::JSAuthorizeConfirmResponse>: NetSceneBase, InstanceCounter<NetSceneBase,100>;
NetSceneBaseEx<micromsg::JSAuthorizeRequest,micromsg::JSAuthorizeResponse>	NetSceneBaseEx<micromsg::JSAuthorizeRequest,micromsg::JSAuthorizeResponse>: NetSceneBase, InstanceCounter<NetSceneBase,100>;
NetSceneBaseEx<micromsg::JSLoginConfirmRequest,micromsg::JSLoginConfirmResponse>	NetSceneBaseEx<micromsg::JSLoginConfirmRequest,micromsg::JSLoginConfirmResponse>: NetSceneBase, InstanceCounter<NetSceneBase,100>;
NetSceneBaseEx<micromsg::JSLoginRequest,micromsg::JSLoginResponse>	NetSceneBaseEx<micromsg::JSLoginRequest,micromsg::JSLoginResponse>: NetSceneBase, InstanceCounter<NetSceneBase,100>;
NetSceneBaseEx<micromsg::JSOperateWxDataRequest,micromsg::JSOperateWxDataResponse>	NetSceneBaseEx<micromsg::JSOperateWxDataRequest,micromsg::JSOperateWxDataResponse>: NetSceneBase, InstanceCounter<NetSceneBase,100>;
NetSceneBaseEx<micromsg::JSRefreshSessionRequest,micromsg::JSRefreshSessionResponse>	NetSceneBaseEx<micromsg::JSRefreshSessionRequest,micromsg::JSRefreshSessionResponse>: NetSceneBase, InstanceCounter<NetSceneBase,100>;
NetSceneBaseEx<micromsg::JoinCloudIMRoomRequest,micromsg::JoinCloudIMRoomResponse>	NetSceneBaseEx<micromsg::JoinCloudIMRoomRequest,micromsg::JoinCloudIMRoomResponse>: NetSceneBase, InstanceCounter<NetSceneBase,100>;
NetSceneBaseEx<micromsg::LaunchWxaAppRequest,micromsg::LaunchWxaAppResponse>	NetSceneBaseEx<micromsg::LaunchWxaAppRequest,micromsg::LaunchWxaAppResponse>: NetSceneBase, InstanceCounter<NetSceneBase,100>;
NetSceneBaseEx<micromsg::LogOutRequest,micromsg::LogOutResponse>	NetSceneBaseEx<micromsg::LogOutRequest,micromsg::LogOutResponse>: NetSceneBase, InstanceCounter<NetSceneBase,100>;
NetSceneBaseEx<micromsg::MMBizJsApiDownloadCdnInfoReq,micromsg::MMBizJsApiDownloadCdnInfoResp>	NetSceneBaseEx<micromsg::MMBizJsApiDownloadCdnInfoReq,micromsg::MMBizJsApiDownloadCdnInfoResp>: NetSceneBase, InstanceCounter<NetSceneBase,100>;
NetSceneBaseEx<micromsg::MMBizJsApiUploadCdnInfoReq,micromsg::MMBizJsApiUploadCdnInfoResp>	NetSceneBaseEx<micromsg::MMBizJsApiUploadCdnInfoReq,micromsg::MMBizJsApiUploadCdnInfoResp>: NetSceneBase, InstanceCounter<NetSceneBase,100>;
NetSceneBaseEx<micromsg::MMListenItemRequest,micromsg::MMListenItemResponse>	NetSceneBaseEx<micromsg::MMListenItemRequest,micromsg::MMListenItemResponse>: NetSceneBase, InstanceCounter<NetSceneBase,100>;
NetSceneBaseEx<micromsg::ModFavItemRequest,micromsg::ModFavItemResponse>	NetSceneBaseEx<micromsg::ModFavItemRequest,micromsg::ModFavItemResponse>: NetSceneBase, InstanceCounter<NetSceneBase,100>;
NetSceneBaseEx<micromsg::ModifyContactLabelListRequest,micromsg::ModifyContactLabelListResponse>	NetSceneBaseEx<micromsg::ModifyContactLabelListRequest,micromsg::ModifyContactLabelListResponse>: NetSceneBase, InstanceCounter<NetSceneBase,100>;
NetSceneBaseEx<micromsg::MultiTalkRequest,micromsg::MultiTalkResponse>	NetSceneBaseEx<micromsg::MultiTalkRequest,micromsg::MultiTalkResponse>: NetSceneBase, InstanceCounter<NetSceneBase,100>;
NetSceneBaseEx<micromsg::NewInitRequest,micromsg::NewInitResponse>	NetSceneBaseEx<micromsg::NewInitRequest,micromsg::NewInitResponse>: NetSceneBase, InstanceCounter<NetSceneBase,100>;
NetSceneBaseEx<micromsg::NewOCRTranslationRequest,micromsg::NewOCRTranslationResponse>	NetSceneBaseEx<micromsg::NewOCRTranslationRequest,micromsg::NewOCRTranslationResponse>: NetSceneBase, InstanceCounter<NetSceneBase,100>;
NetSceneBaseEx<micromsg::OpenForwardMsgViewSpamRequest,micromsg::OpenForwardMsgViewSpamResponse>	NetSceneBaseEx<micromsg::OpenForwardMsgViewSpamRequest,micromsg::OpenForwardMsgViewSpamResponse>: NetSceneBase, InstanceCounter<NetSceneBase,100>;
NetSceneBaseEx<micromsg::OpenIMSyncRequest,micromsg::OpenIMSyncResponse>	NetSceneBaseEx<micromsg::OpenIMSyncRequest,micromsg::OpenIMSyncResponse>: NetSceneBase, InstanceCounter<NetSceneBase,100>;
NetSceneBaseEx<micromsg::ParallelUploadRequest,micromsg::ParallelUploadResponse>	NetSceneBaseEx<micromsg::ParallelUploadRequest,micromsg::ParallelUploadResponse>: NetSceneBase, InstanceCounter<NetSceneBase,100>;
NetSceneBaseEx<micromsg::PcWebTranslateRequestReq,micromsg::PcWebTranslateRequestResp>	NetSceneBaseEx<micromsg::PcWebTranslateRequestReq,micromsg::PcWebTranslateRequestResp>: NetSceneBase, InstanceCounter<NetSceneBase,100>;
NetSceneBaseEx<micromsg::PrevDownloadCheckRequest,micromsg::PrevDownloadCheckResponse>	NetSceneBaseEx<micromsg::PrevDownloadCheckRequest,micromsg::PrevDownloadCheckResponse>: NetSceneBase, InstanceCounter<NetSceneBase,100>;
NetSceneBaseEx<micromsg::PushLoginURLRequest,micromsg::PushLoginURLResponse>	NetSceneBaseEx<micromsg::PushLoginURLRequest,micromsg::PushLoginURLResponse>: NetSceneBase, InstanceCounter<NetSceneBase,100>;
NetSceneBaseEx<micromsg::QuitBizChatReq,micromsg::QuitBizChatResp>	NetSceneBaseEx<micromsg::QuitBizChatReq,micromsg::QuitBizChatResp>: NetSceneBase, InstanceCounter<NetSceneBase,100>;
NetSceneBaseEx<micromsg::QyMsgStateNotifyReq,micromsg::QyMsgStateNotifyResp>	NetSceneBaseEx<micromsg::QyMsgStateNotifyReq,micromsg::QyMsgStateNotifyResp>: NetSceneBase, InstanceCounter<NetSceneBase,100>;
NetSceneBaseEx<micromsg::RcptInfoQueryRequest,micromsg::RcptInfoQueryResponse>	NetSceneBaseEx<micromsg::RcptInfoQueryRequest,micromsg::RcptInfoQueryResponse>: NetSceneBase, InstanceCounter<NetSceneBase,100>;
NetSceneBaseEx<micromsg::ReportClientCheckRequest,micromsg::ReportClientCheckResponse>	NetSceneBaseEx<micromsg::ReportClientCheckRequest,micromsg::ReportClientCheckResponse>: NetSceneBase, InstanceCounter<NetSceneBase,100>;
NetSceneBaseEx<micromsg::ReportExptAppInfoRequest,micromsg::ReportExptAppInfoResponse>	NetSceneBaseEx<micromsg::ReportExptAppInfoRequest,micromsg::ReportExptAppInfoResponse>: NetSceneBase, InstanceCounter<NetSceneBase,100>;
NetSceneBaseEx<micromsg::ReportServerDataRequest,micromsg::ReportServerDataResponse>	NetSceneBaseEx<micromsg::ReportServerDataRequest,micromsg::ReportServerDataResponse>: NetSceneBase, InstanceCounter<NetSceneBase,100>;
NetSceneBaseEx<micromsg::ReportWxaAppExposeRequest,micromsg::ReportWxaAppExposeResponse>	NetSceneBaseEx<micromsg::ReportWxaAppExposeRequest,micromsg::ReportWxaAppExposeResponse>: NetSceneBase, InstanceCounter<NetSceneBase,100>;
NetSceneBaseEx<micromsg::RevokeMsgRequest,micromsg::RevokeMsgResponse>	NetSceneBaseEx<micromsg::RevokeMsgRequest,micromsg::RevokeMsgResponse>: NetSceneBase, InstanceCounter<NetSceneBase,100>;
NetSceneBaseEx<micromsg::RoomToolsAlterWxAppRequest,micromsg::RoomToolsAlterWxAppResponse>	NetSceneBaseEx<micromsg::RoomToolsAlterWxAppRequest,micromsg::RoomToolsAlterWxAppResponse>: NetSceneBase, InstanceCounter<NetSceneBase,100>;
NetSceneBaseEx<micromsg::RouteRequest,micromsg::RouteResponse>	NetSceneBaseEx<micromsg::RouteRequest,micromsg::RouteResponse>: NetSceneBase, InstanceCounter<NetSceneBase,100>;
NetSceneBaseEx<micromsg::SaveUserAutoFillInfoReq,micromsg::SaveUserAutoFillInfoResp>	NetSceneBaseEx<micromsg::SaveUserAutoFillInfoReq,micromsg::SaveUserAutoFillInfoResp>: NetSceneBase, InstanceCounter<NetSceneBase,100>;
NetSceneBaseEx<micromsg::SearchContactRequest,micromsg::SearchContactResponse>	NetSceneBaseEx<micromsg::SearchContactRequest,micromsg::SearchContactResponse>: NetSceneBase, InstanceCounter<NetSceneBase,100>;
NetSceneBaseEx<micromsg::SendAppMsgRequest,micromsg::SendAppMsgResponse>	NetSceneBaseEx<micromsg::SendAppMsgRequest,micromsg::SendAppMsgResponse>: NetSceneBase, InstanceCounter<NetSceneBase,100>;
NetSceneBaseEx<micromsg::SendFeedbackRequest,micromsg::SendFeedbackResponse>	NetSceneBaseEx<micromsg::SendFeedbackRequest,micromsg::SendFeedbackResponse>: NetSceneBase, InstanceCounter<NetSceneBase,100>;
NetSceneBaseEx<micromsg::SendFileUploadMsgReq,micromsg::SendFileUploadMsgResp>	NetSceneBaseEx<micromsg::SendFileUploadMsgReq,micromsg::SendFileUploadMsgResp>: NetSceneBase, InstanceCounter<NetSceneBase,100>;
NetSceneBaseEx<micromsg::SendPatRequest,micromsg::SendPatResponse>	NetSceneBaseEx<micromsg::SendPatRequest,micromsg::SendPatResponse>: NetSceneBase, InstanceCounter<NetSceneBase,100>;
NetSceneBaseEx<micromsg::SetChatRoomAnnouncementRequest,micromsg::SetChatRoomAnnouncementResponse>	NetSceneBaseEx<micromsg::SetChatRoomAnnouncementRequest,micromsg::SetChatRoomAnnouncementResponse>: NetSceneBase, InstanceCounter<NetSceneBase,100>;
NetSceneBaseEx<micromsg::ShareTransIdRequest,micromsg::ShareTransIdResponse>	NetSceneBaseEx<micromsg::ShareTransIdRequest,micromsg::ShareTransIdResponse>: NetSceneBase, InstanceCounter<NetSceneBase,100>;
NetSceneBaseEx<micromsg::ShowAuthorizeUserIDReq,micromsg::ShowAuthorizeUserIDResp>	NetSceneBaseEx<micromsg::ShowAuthorizeUserIDReq,micromsg::ShowAuthorizeUserIDResp>: NetSceneBase, InstanceCounter<NetSceneBase,100>;
NetSceneBaseEx<micromsg::SnsADCommentRequest,micromsg::SnsADCommentResponse>	NetSceneBaseEx<micromsg::SnsADCommentRequest,micromsg::SnsADCommentResponse>: NetSceneBase, InstanceCounter<NetSceneBase,100>;
NetSceneBaseEx<micromsg::SnsADObjectDetailRequest,micromsg::SnsADObjectDetailResponse>	NetSceneBaseEx<micromsg::SnsADObjectDetailRequest,micromsg::SnsADObjectDetailResponse>: NetSceneBase, InstanceCounter<NetSceneBase,100>;
NetSceneBaseEx<micromsg::SnsCommentRequest,micromsg::SnsCommentResponse>	NetSceneBaseEx<micromsg::SnsCommentRequest,micromsg::SnsCommentResponse>: NetSceneBase, InstanceCounter<NetSceneBase,100>;
NetSceneBaseEx<micromsg::SnsObjectDetailRequest,micromsg::SnsObjectDetailResponse>	NetSceneBaseEx<micromsg::SnsObjectDetailRequest,micromsg::SnsObjectDetailResponse>: NetSceneBase, InstanceCounter<NetSceneBase,100>;
NetSceneBaseEx<micromsg::SnsObjectOpRequest,micromsg::SnsObjectOpResponse>	NetSceneBaseEx<micromsg::SnsObjectOpRequest,micromsg::SnsObjectOpResponse>: NetSceneBase, InstanceCounter<NetSceneBase,100>;
NetSceneBaseEx<micromsg::SnsSyncRequest,micromsg::SnsSyncResponse>	NetSceneBaseEx<micromsg::SnsSyncRequest,micromsg::SnsSyncResponse>: NetSceneBase, InstanceCounter<NetSceneBase,100>;
NetSceneBaseEx<micromsg::SnsTimeLineRequest,micromsg::SnsTimeLineResponse>	NetSceneBaseEx<micromsg::SnsTimeLineRequest,micromsg::SnsTimeLineResponse>: NetSceneBase, InstanceCounter<NetSceneBase,100>;
NetSceneBaseEx<micromsg::SnsUserPageRequest,micromsg::SnsUserPageResponse>	NetSceneBaseEx<micromsg::SnsUserPageRequest,micromsg::SnsUserPageResponse>: NetSceneBase, InstanceCounter<NetSceneBase,100>;
NetSceneBaseEx<micromsg::StatusNotifyRequest,micromsg::StatusNotifyResponse>	NetSceneBaseEx<micromsg::StatusNotifyRequest,micromsg::StatusNotifyResponse>: NetSceneBase, InstanceCounter<NetSceneBase,100>;
NetSceneBaseEx<micromsg::SubmitAuthorizeUserIDReq,micromsg::SubmitAuthorizeUserIDResp>	NetSceneBaseEx<micromsg::SubmitAuthorizeUserIDReq,micromsg::SubmitAuthorizeUserIDResp>: NetSceneBase, InstanceCounter<NetSceneBase,100>;
NetSceneBaseEx<micromsg::SubscribeMsgReq,micromsg::SubscribeMsgResp>	NetSceneBaseEx<micromsg::SubscribeMsgReq,micromsg::SubscribeMsgResp>: NetSceneBase, InstanceCounter<NetSceneBase,100>;
NetSceneBaseEx<micromsg::TenPayRequest,micromsg::TenPayResponse>	NetSceneBaseEx<micromsg::TenPayRequest,micromsg::TenPayResponse>: NetSceneBase, InstanceCounter<NetSceneBase,100>;
NetSceneBaseEx<micromsg::TimelineGetOftenReadBizReq,micromsg::TimelineGetOftenReadBizResp>	NetSceneBaseEx<micromsg::TimelineGetOftenReadBizReq,micromsg::TimelineGetOftenReadBizResp>: NetSceneBase, InstanceCounter<NetSceneBase,100>;
NetSceneBaseEx<micromsg::TranslateLinkReq,micromsg::TranslateLinkResp>	NetSceneBaseEx<micromsg::TranslateLinkReq,micromsg::TranslateLinkResp>: NetSceneBase, InstanceCounter<NetSceneBase,100>;
NetSceneBaseEx<micromsg::UpdateBizChatMemberListReq,micromsg::UpdateBizChatMemberListResp>	NetSceneBaseEx<micromsg::UpdateBizChatMemberListReq,micromsg::UpdateBizChatMemberListResp>: NetSceneBase, InstanceCounter<NetSceneBase,100>;
NetSceneBaseEx<micromsg::UpdateBizChatReq,micromsg::UpdateBizChatResp>	NetSceneBaseEx<micromsg::UpdateBizChatReq,micromsg::UpdateBizChatResp>: NetSceneBase, InstanceCounter<NetSceneBase,100>;
NetSceneBaseEx<micromsg::UpdateContactLabelRequest,micromsg::UpdateContactLabelResponse>	NetSceneBaseEx<micromsg::UpdateContactLabelRequest,micromsg::UpdateContactLabelResponse>: NetSceneBase, InstanceCounter<NetSceneBase,100>;
NetSceneBaseEx<micromsg::UpdateWxaStarRecordRequest,micromsg::UpdateWxaStarRecordResponse>	NetSceneBaseEx<micromsg::UpdateWxaStarRecordRequest,micromsg::UpdateWxaStarRecordResponse>: NetSceneBase, InstanceCounter<NetSceneBase,100>;
NetSceneBaseEx<micromsg::UpdateWxaUsageRecordRequest,micromsg::UpdateWxaUsageRecordResponse>	NetSceneBaseEx<micromsg::UpdateWxaUsageRecordRequest,micromsg::UpdateWxaUsageRecordResponse>: NetSceneBase, InstanceCounter<NetSceneBase,100>;
NetSceneBaseEx<micromsg::UploadAppAttachRequest,micromsg::UploadAppAttachResponse>	NetSceneBaseEx<micromsg::UploadAppAttachRequest,micromsg::UploadAppAttachResponse>: NetSceneBase, InstanceCounter<NetSceneBase,100>;
NetSceneBaseEx<micromsg::UploadCardImgRequest,micromsg::UploadCardImgResponse>	NetSceneBaseEx<micromsg::UploadCardImgRequest,micromsg::UploadCardImgResponse>: NetSceneBase, InstanceCounter<NetSceneBase,100>;
NetSceneBaseEx<micromsg::UploadCheckHitMd5Request,micromsg::UploadCheckHitMd5Response>	NetSceneBaseEx<micromsg::UploadCheckHitMd5Request,micromsg::UploadCheckHitMd5Response>: NetSceneBase, InstanceCounter<NetSceneBase,100>;
NetSceneBaseEx<micromsg::UploadEmojiRequest,micromsg::UploadEmojiResponse>	NetSceneBaseEx<micromsg::UploadEmojiRequest,micromsg::UploadEmojiResponse>: NetSceneBase, InstanceCounter<NetSceneBase,100>;
NetSceneBaseEx<micromsg::UploadFileFinishNoticeRequest,micromsg::UploadFileFinishNoticeResponse>	NetSceneBaseEx<micromsg::UploadFileFinishNoticeRequest,micromsg::UploadFileFinishNoticeResponse>: NetSceneBase, InstanceCounter<NetSceneBase,100>;
NetSceneBaseEx<micromsg::UploadMsgImgRequest,micromsg::UploadMsgImgResponse>	NetSceneBaseEx<micromsg::UploadMsgImgRequest,micromsg::UploadMsgImgResponse>: NetSceneBase, InstanceCounter<NetSceneBase,100>;
NetSceneBaseEx<micromsg::UploadVideoRequest,micromsg::UploadVideoResponse>	NetSceneBaseEx<micromsg::UploadVideoRequest,micromsg::UploadVideoResponse>: NetSceneBase, InstanceCounter<NetSceneBase,100>;
NetSceneBaseEx<micromsg::UploadVoiceForTransRequest,micromsg::UploadVoiceForTransResponse>	NetSceneBaseEx<micromsg::UploadVoiceForTransRequest,micromsg::UploadVoiceForTransResponse>: NetSceneBase, InstanceCounter<NetSceneBase,100>;
NetSceneBaseEx<micromsg::VerifyAndroidIapPackageReq,micromsg::VerifyAndroidIapPackageResp>	NetSceneBaseEx<micromsg::VerifyAndroidIapPackageReq,micromsg::VerifyAndroidIapPackageResp>: NetSceneBase, InstanceCounter<NetSceneBase,100>;
NetSceneBaseEx<micromsg::VerifyPluginRequest,micromsg::VerifyPluginResponse>	NetSceneBaseEx<micromsg::VerifyPluginRequest,micromsg::VerifyPluginResponse>: NetSceneBase, InstanceCounter<NetSceneBase,100>;
NetSceneBaseEx<micromsg::VerifyUserRequest,micromsg::VerifyUserResponse>	NetSceneBaseEx<micromsg::VerifyUserRequest,micromsg::VerifyUserResponse>: NetSceneBase, InstanceCounter<NetSceneBase,100>;
NetSceneBaseEx<micromsg::VoIPMtAddMemberRequest,micromsg::VoIPMtAddMemberResponse>	NetSceneBaseEx<micromsg::VoIPMtAddMemberRequest,micromsg::VoIPMtAddMemberResponse>: NetSceneBase, InstanceCounter<NetSceneBase,100>;
NetSceneBaseEx<micromsg::VoIPMtCreateRequest,micromsg::VoIPMtCreateResponse>	NetSceneBaseEx<micromsg::VoIPMtCreateRequest,micromsg::VoIPMtCreateResponse>: NetSceneBase, InstanceCounter<NetSceneBase,100>;
NetSceneBaseEx<micromsg::VoIPMtGetAuthCodeRequest,micromsg::VoIPMtGetAuthCodeResponse>	NetSceneBaseEx<micromsg::VoIPMtGetAuthCodeRequest,micromsg::VoIPMtGetAuthCodeResponse>: NetSceneBase, InstanceCounter<NetSceneBase,100>;
NetSceneBaseEx<micromsg::VoIPMtGetSDKModeRequest,micromsg::VoIPMtGetSDKModeResponse>	NetSceneBaseEx<micromsg::VoIPMtGetSDKModeRequest,micromsg::VoIPMtGetSDKModeResponse>: NetSceneBase, InstanceCounter<NetSceneBase,100>;
NetSceneBaseEx<micromsg::VoIPMtGetSDKUserInfoRequest,micromsg::VoIPMtGetSDKUserInfoResponse>	NetSceneBaseEx<micromsg::VoIPMtGetSDKUserInfoRequest,micromsg::VoIPMtGetSDKUserInfoResponse>: NetSceneBase, InstanceCounter<NetSceneBase,100>;
NetSceneBaseEx<micromsg::VoIPMtInviteRequest,micromsg::VoIPMtInviteResponse>	NetSceneBaseEx<micromsg::VoIPMtInviteRequest,micromsg::VoIPMtInviteResponse>: NetSceneBase, InstanceCounter<NetSceneBase,100>;
NetSceneBaseEx<micromsg::VoIPMtJoinRequest,micromsg::VoIPMtJoinResponse>	NetSceneBaseEx<micromsg::VoIPMtJoinRequest,micromsg::VoIPMtJoinResponse>: NetSceneBase, InstanceCounter<NetSceneBase,100>;
NetSceneBaseEx<micromsg::VoIPMtScreenSharingSecurityCheckRequest,micromsg::VoIPMtScreenSharingSecurityCheckResponse>	NetSceneBaseEx<micromsg::VoIPMtScreenSharingSecurityCheckRequest,micromsg::VoIPMtScreenSharingSecurityCheckResponse>: NetSceneBase, InstanceCounter<NetSceneBase,100>;
NetSceneBaseEx<micromsg::VoIPMtSendBannerMsgRequest,micromsg::VoIPMtSendBannerMsgResponse>	NetSceneBaseEx<micromsg::VoIPMtSendBannerMsgRequest,micromsg::VoIPMtSendBannerMsgResponse>: NetSceneBase, InstanceCounter<NetSceneBase,100>;
NetSceneBaseEx<micromsg::VoipAckReq,micromsg::VoipAckResp>	NetSceneBaseEx<micromsg::VoipAckReq,micromsg::VoipAckResp>: NetSceneBase, InstanceCounter<NetSceneBase,100>;
NetSceneBaseEx<micromsg::VoipAnswerReq,micromsg::VoipAnswerResp>	NetSceneBaseEx<micromsg::VoipAnswerReq,micromsg::VoipAnswerResp>: NetSceneBase, InstanceCounter<NetSceneBase,100>;
NetSceneBaseEx<micromsg::VoipCancelInviteReq,micromsg::VoipCancelInviteResp>	NetSceneBaseEx<micromsg::VoipCancelInviteReq,micromsg::VoipCancelInviteResp>: NetSceneBase, InstanceCounter<NetSceneBase,100>;
NetSceneBaseEx<micromsg::VoipHeartBeatReq,micromsg::VoipHeartBeatResp>	NetSceneBaseEx<micromsg::VoipHeartBeatReq,micromsg::VoipHeartBeatResp>: NetSceneBase, InstanceCounter<NetSceneBase,100>;
NetSceneBaseEx<micromsg::VoipILinkCommonRequest,micromsg::VoipILinkCommonResponse>	NetSceneBaseEx<micromsg::VoipILinkCommonRequest,micromsg::VoipILinkCommonResponse>: NetSceneBase, InstanceCounter<NetSceneBase,100>;
NetSceneBaseEx<micromsg::VoipInviteReq,micromsg::VoipInviteResp>	NetSceneBaseEx<micromsg::VoipInviteReq,micromsg::VoipInviteResp>: NetSceneBase, InstanceCounter<NetSceneBase,100>;
NetSceneBaseEx<micromsg::VoipShutDownReq,micromsg::VoipShutDownResp>	NetSceneBaseEx<micromsg::VoipShutDownReq,micromsg::VoipShutDownResp>: NetSceneBase, InstanceCounter<NetSceneBase,100>;
NetSceneBaseEx<micromsg::VoipStatReportReq,micromsg::VoipStatReportResp>	NetSceneBaseEx<micromsg::VoipStatReportReq,micromsg::VoipStatReportResp>: NetSceneBase, InstanceCounter<NetSceneBase,100>;
NetSceneBaseEx<micromsg::VoipSyncReq,micromsg::VoipSyncResp>	NetSceneBaseEx<micromsg::VoipSyncReq,micromsg::VoipSyncResp>: NetSceneBase, InstanceCounter<NetSceneBase,100>;
NetSceneBaseEx<micromsg::WeAppBasePcConfigRequest,micromsg::WeAppBasePcConfigResponse>	NetSceneBaseEx<micromsg::WeAppBasePcConfigRequest,micromsg::WeAppBasePcConfigResponse>: NetSceneBase, InstanceCounter<NetSceneBase,100>;
NetSceneBaseEx<micromsg::WxaAppGetAuthInfoReq,micromsg::WxaAppGetAuthInfoResp>	NetSceneBaseEx<micromsg::WxaAppGetAuthInfoReq,micromsg::WxaAppGetAuthInfoResp>: NetSceneBase, InstanceCounter<NetSceneBase,100>;
NetSceneBaseEx<micromsg::WxaAppGetPublicLibInfoRequest,micromsg::WxaAppGetPublicLibInfoResponse>	NetSceneBaseEx<micromsg::WxaAppGetPublicLibInfoRequest,micromsg::WxaAppGetPublicLibInfoResponse>: NetSceneBase, InstanceCounter<NetSceneBase,100>;
NetSceneBaseEx<micromsg::WxaAppGetShareInfoRequest,micromsg::WxaAppGetShareInfoResponse>	NetSceneBaseEx<micromsg::WxaAppGetShareInfoRequest,micromsg::WxaAppGetShareInfoResponse>: NetSceneBase, InstanceCounter<NetSceneBase,100>;
NetSceneBaseEx<micromsg::WxaAttrSyncRequest,micromsg::WxaAttrSyncResponse>	NetSceneBaseEx<micromsg::WxaAttrSyncRequest,micromsg::WxaAttrSyncResponse>: NetSceneBase, InstanceCounter<NetSceneBase,100>;
NetSceneBaseEx<micromsg::WxaJsApiInfoRequest,micromsg::WxaJsApiInfoResponse>	NetSceneBaseEx<micromsg::WxaJsApiInfoRequest,micromsg::WxaJsApiInfoResponse>: NetSceneBase, InstanceCounter<NetSceneBase,100>;
NetSceneBaseEx<micromsg::WxaPcMsgChannelRequest,micromsg::WxaPcMsgChannelResponse>	NetSceneBaseEx<micromsg::WxaPcMsgChannelRequest,micromsg::WxaPcMsgChannelResponse>: NetSceneBase, InstanceCounter<NetSceneBase,100>;